    {
  "width": 20,
  "height": 20,
  "start": [1, 0],
  "goal": [18, 18],
  "move": 4,
  "cells": [
    [0,0,0,0,0,0,0,0,0,1,0,0,0,0,0,0,0,0,0,0],
    [0,1,1,1,0,0,0,1,0,1,0,1,1,1,1,1,0,1,1,0],
    [0,0,0,1,0,1,0,1,0,1,0,0,0,0,0,1,0,0,1,0],
    [0,1,0,1,0,1,0,1,0,1,1,1,1,1,0,1,1,0,1,0],
    [0,1,0,0,0,1,0,0,0,0,0,0,1,0,0,0,1,0,0,0],
    [0,1,1,1,0,1,1,1,1,1,0,1,1,0,1,0,1,1,1,0],
    [0,0,0,1,0,0,0,0,0,1,0,0,0,0,1,0,0,0,1,0],
    [1,1,0,1,1,1,1,1,0,1,1,1,1,0,1,1,1,0,1,0],
    [0,0,0,0,0,0,0,1,0,0,0,0,1,0,0,0,1,0,0,0],
    [0,1,1,1,1,1,0,1,1,1,1,0,1,1,1,0,1,1,1,0],
    [0,0,0,0,0,1,0,0,0,0,1,0,0,0,1,0,0,0,1,0],
    [0,1,1,1,0,1,1,1,1,0,1,1,1,0,1,1,1,0,1,0],
    [0,0,0,1,0,0,0,0,1,0,0,0,1,0,0,0,1,0,0,0],
    [1,1,0,1,1,1,1,0,1,1,1,0,1,1,1,0,1,1,1,0],
    [0,0,0,0,0,0,0,0,0,1,0,0,0,0,0,0,0,0,1,0],
    [0,1,1,1,1,1,1,1,0,1,0,1,1,1,1,1,1,0,1,0],
    [0,0,0,0,0,0,0,1,0,0,0,0,0,0,0,1,0,0,0,0],
    [0,1,1,1,1,1,0,1,1,1,1,1,0,1,0,1,1,1,1,0],
    [0,0,0,0,0,0,0,0,0,1,0,0,0,1,0,0,0,0,0,0],
    [0,1,1,1,1,1,1,1,0,1,0,1,1,1,1,1,0,1,1,0]
  ]
}
